R 1280 1080
NO ./textures/north.xpm
SO ./textures/south.xpm
WE ./textures/west.xpm
EA ./textures/east.xpm
S ./textures/sprite.xpm
F 176,176,255
C 0,0,0

        1111111111111111111111111         1111111111111111111111111
        1000000000110000000000001         1000000000110000000000001
        1011000001110000000200001         1011000001110002000200001
        100100000000000000000000111111111110010000000000000000000011
11111111101100000111000000000000000000000010110000011100000022000001
10000000001101110111010111111111111000200000110111011101011111111111
11110111111111 111 1000010201     11110111111111 111 1000010201
11110111111111111111010010001     11110111111111111111010010001
11000000110101011100000000201     11000000110101011100000000201
10000000000000001100000010001     10000000000000001100000010001
10000000000000001101010010001     10000000000000001101010010001
11000001110101011111011110N011111111000001110101011111011110001
11110111 1110101 1011110100000000000000111 1110101 101111010001
11111111 1111111 1111111111111111111111111 1111111 111111111111