R 1280 1080
NO ./textures/north.xpm
SO ./textures/south.xpm
WE ./textures/west.xpm
EA ./textures/east.xpm
S ./textures/sprite.xpm
F 176,176,255
C 0,0,0

         1111111111111111111111111         1111111111111111111111111
         1000000000110000000000001         1000000000110000000000001
         1011000001110000000200001         1011000001110002000200001
         100100000000000000000000111111111110010000000000000000000011
 11111111101100000111000000000000000000000010110000011100000022000001
 10000000001101110111010111111111111000000000110111011101011111111111
 11110111111111 111 1000010201     11110111111111 111 1000010201
 11110111111111111111010010001     11110111111111111111010010001
 11000000110101011100000000201     11000000110101011100000000201
 10000000000000001100000010001     10000000000000001100000010001
 10000000000000001101010010001     10000000000000000001010010001
 11000001110101011111011110N011111111000001110101011111011110001
 11110111 1110101 1011110100000000000000111 1110101 101111010001
 11100111 1111111 1111111111111111111111111 1111111 111111111111
 111001111111111
 100000000000001
 101111101110111
 100010001000001
 111110111111101
 100010000010001
11110101110111111
10000001000100001
11111101110101111
100000100000101
101101101110101
101000100000001
101110101110111
120000100010021
111111111111111