R 1000 1080
NO ./textures/north.xpm
SO ./textures/south.xpm
WE ./textures/west.xpm
EA ./textures/east.xpm
S ./textures/sprite.xpm
                              
F 0,0,0
C 169,169,169

        1111111111111111111111111
        1000000000110000000000001
        1011000001110000222222221
        1001000000000000222222221
111111111011000001110000222222221
100000000011011101110101111111111
11110111111111 111 10000102011111
111101111111111111110100100011111
110000001101010111000000002011111
100000000000000011000000100011111
100000000000000011010100100011111
11000001110101011111011110S011111
11110111 1110101 1011110100011111
11111111 1111111 1111111111111111